X1111111111111111111111111111111111111111
1122222222222222222222222222221222222#11
1121111111111111111122222222221222122211
1122222222222222222124211122221222122211
1122#24222222422222122215112221222122211
1122222222222222222122212212222223122211
1122211111111111111111112212222522122211
1122212222222212222222212211111111122211
1122222222222212222222212222222222222211
1122111111111112222222111111111111122211
1112222122222212222222212222222222222111
11@2222122222212222222212222222222222@11
1112222123222211111111111111111111222111
1122222122242222222222212222222221222211
1122222122222222222222212222222221222211
1122222222252222222222512222222221222211
1122222222222222222222212222225221222211
1124222211111111111111112222222222222211
1122222212222212222222211111111112212211
1121111212222222222222222222122222212211
1122251212222211111111111111121112212211
1122221222222212222222221222222211112211
112222111111111111111122122222#222212211
1122222212222212222221221222422222212211
112#252213222412222221222222222222212211
1122222222222222222222222222222232222211
1111111111111111111111111111111111111111
0000000000000000000000000000000000000000
0000000000000000000000000000000000000000
0000000000000000000000000000000000000000