X1111111111111111111111111111111111111111
1122222222122222122222222222222222222211
1122211111122222122111111112215221232211
1122212222222222122222222211112222212211
1122222221222222122222222222225224222211
1122111111111111111111111111111111122211
1122222212222222122222221222221222122211
1122222222222#22122#22222222222222222211
11@2212212222222122222211111122222222211
1122222222222#22122#2222222212212@221211
1122222212222222122222222222122222212211
1122111111111111111111111111122111222211
1122122222222222122222222212222221212211
1122122222222122121232222211111221222211
1122242212222222122252212222222221222211
1122312212124122121222212222222421222211
1122222212222222222222212211112221212211
1122212212422212521221212232212221222211
1121522212222222222222212222212221222211
1122222211111111111111112222222221212211
1122222222222222322222222221111111222211
1122111111111222222222222221222222222211
1122222222221211111111111111221111122211
1122422222221222222222222222222222122211
1121222211111111111111112222224222121211
1122222222222222222222222222222252122211
1111111111111111111111111111111111111111
0000000000000000000000000000000000000000
0000000000000000000000000000000000000000
0000000000000000000000000000000000000000