X1111111111111111111111111111111111111111
1122222222222222222222222222222222222211
1122111111111122222222211111122221112211
1122122222222122224222212322122212421211
1122111222211122222222211221122122222111
1122222222222222222222222222222221212211
1122222222211222112222222222222221112211
11222#222221222221222212122222#222222211
1122222222212232212225111222222222222211
1122222222211111112222222222222224222211
1122222111122222222222222224222222222211
1122221222212222222222222222222222222211
11@2212224221252222221111112222111122@11
1122212222221222222221232212222122122211
1122212252221222222221222212222122122211
1122222222222222222221122112222242222211
1122222222111111122222222222222222222211
1122222222122322122225222222222222222211
1122222222122222122222222222222222252211
1122222222112221122252222111111112222211
11222#2222222222222522222122222212222211
1122222222222222222222222222222222222211
1121111111222121222222221112222222222211
11212222212212221222222122212222#2222211
1121222221222121222222112221122222522211
1122224222222222222222222222222222222211
1111111111111111111111111111111111111111
0000000000000000000000000000000000000000
0000000000000000000000000000000000000000
0000000000000000000000000000000000000000