X1111111111111111111111111111111111111111
1132222222222222222522222222222222222311
1152222222222222111111222222221111111111
1111111112222222111111222222222222222411
1122111112222#2222221132222222222#222211
1122111112222222222211111222222222222211
1122111112222221222211111222222222222211
1122222222222251222222222222111122222211
1122222222222111222222222222223122222211
1122222222222222222222222222222122222211
1122222222222222212122222222222122222411
1112111112111111122211112111111111112111
1112222222222222124212222222222222222111
11@2222222222222222222222222222222222@11
1112222222222222224222222222222222222111
1112111112111111122211112111111111112111
1122222222222222212122222222222222222211
1122211222222222222222222222222222222211
11222412222222#2222222#22222222212222211
1122221222222211111222222222222512222211
1122222222222222241222222222111112222211
1122222222222222221222222222222222222211
1122222211122222221222222211222222222211
1122222222222222222222222222222222222211
1111111112111112222222222211121111111111
1132222222222222222522222212222222222311
1111111111111111111111111111111111111111
0000000000000000000000000000000000000000
0000000000000000000000000000000000000000
0000000000000000000000000000000000000000

