X1111111111111111111111111111111111111111
1142222222222222222322222222222222222411
1122222222111111222522221111112222222211
1111111122155551111111111444412211111111
1122222122122221111111111222212212222211
1122222122122221111111111222212212222211
1122222122122221111111111222212212222211
1122222112122222221122222222212112222211
1122222222222222222222222222222222222211
1122222222222222222222222222222222222211
11#2222222222222222222222222222222222#11
1112111112122111211112111122111111112111
1112111112122122221122222122111111112111
1112222222122221211112122222222222222111
11@2222222222221243352122222222222222@11
1112222222222221211112122222122222222111
1112111112122122221122222122111111112111
1112111112122121211112122122111111112111
11#2222222222222222222222222222222222#11
1122222222222222221122222222222222222211
1122221111112111111111111121111111222211
1122221122222221111111112222222211222211
1111211122222221111111112222222211121111
1122222222222221111111112222222222222211
1122211111112221122522112222111111123211
1142211111112222222322222222111111122411
1111111111111111111111111111111111111111
0000000000000000000000000000000000000000
0000000000000000000000000000000000000000
0000000000000000000000000000000000000000

