X1111111111111111111111111111111111111111
1122222222222222222222222222222222222211
1122222222222211222111111111111111112211
1122522222#22211222122222222212222212211
1122222222222211222122222322212224212211
1122211111111111222122222222212222212211
1122222222223222222212222211111112212211
1125222222222222222221222222222222212211
1122222222122224222222122222522322212211
1122222222212222222222212222222222212211
1122211111111222225222221222222222#22211
1122222222222122222222222122222222222211
1122221111112211111121111112222111111211
1122@22222212221222222222221222222221211
1122222222212222122222222222122222221211
11222222222222222111111111111122222@1211
1122211111111222221222222222221222221211
1122222222221222222122222222221222221211
1122111111111111222212222222221222221211
1122222222222122221111222222222222221211
1122422222222125221221222111111111111211
1121112322222122111221322222222222222211
1122212222222122225221222222242222222211
1122211111111111222221221111111112222211
1122222222222222222222222221222222242211
115224222222222222#222222221222222222#11
1111111111111111111111111111111111111111
0000000000000000000000000000000000000000
0000000000000000000000000000000000000000
0000000000000000000000000000000000000000