X1111111111111111111111111111111111111111
1122222222222222222222222222222222222211
1122111111111111111212223212122111112211
1122222222222222221222215222222122212211
112222122222222222122222222222212#212211
1122322222422222#21111111111111122212211
1121222222222222222222221222122212212211
1122221222231221222212222222122252112211
1122221222221222252222222222122222122211
1122221222221222222221222111122222121211
1122221111111111112322222122222222222211
11@2222222222222212221222122122322222@11
1122222122212222212222222122222222122211
1122222222221222211111111111122212221211
1122122122222242222122222222122222222211
112222222222222222212221222212#222122211
1122211111111111222122222222122222222211
1122222222222221222122122225122222222211
1121221111111111111122222111111111121211
1122222222221222222222222222222222122211
11222#2222521221312224221222223222122211
1122222222222222222222222222222222122211
1122211111111111111111122224222111122211
1122222222221212222222122211111122222211
1121252122221222221222121222222242212211
1122222222232222222222222222222222222211
1111111111111111111111111111111111111111
0000000000000000000000000000000000000000
0000000000000000000000000000000000000000
0000000000000000000000000000000000000000