X1111111111111111111111111111111111111111
1122222222222222222222222222222222222211
1122222211222222222224222222212221222211
1122222122222222222222222222211111222211
1122221522222222111122211222212221222211
1122212221111121222212211211112321111211
1122124222212212225221211212222222221211
1122212252212212424221211212222222221211
1122221111112221122112211213222222231211
1122222222222222222222244212222222221211
1122222222222222242222222212222322221211
1122222422222222222222222212222222221211
1122222222222222222522222212222222221211
1125222522422222222222222212222222221211
1122222222222222222222222212222222221211
112222222252225222222222#222222222221211
1122222222222222222222222222222111111211
112222224222224222222222#22#222222222211
112222222222222222222#222222222222222211
1122222222222222222222222222222242222211
1122222222222222222222222222222222222211
1122111111111111222222222222222222222211
11221@2322222222222222224422222222222211
11221@2322222222222222222222222222222211
1122111111111111222522222522252222222211
1122222222222222222222222222222222222211
1111111111111111111111111111111111111111
0000000000000000000000000000000000000000
0000000000000000000000000000000000000000
0000000000000000000000000000000000000000