X1111111111111111111111111111111111111111
11#22252222222222222222222222222222522#1
1122321111111121111111121111111122223211
1124221111111121111111121422222222242211
1122211221212222222222121422222212224211
1124211221222222222222121111222111122211
1122211221211111111111121222222225122211
1122211211211111111111111111111115122211
1122211211411222222222111111111111122211
1122211211111222222222222222212222222211
1122211222222222222222222222222222222211
1122211111222222111221112221111111121111
1122211111222222122222212222122222222211
1112242221222222122522212222122222222111
11@2222222222222111111112222222222222@11
1112224221222222221212222222122122122111
1125522221111112221212211111122122122211
1122242221422212221212212225122122122211
1122122221222222222222222222122122122211
1122122211111211112221111111122111111211
1122122211111211112221111111122111111211
1122122215222222122222122222222222221211
1122112215222222222222222222222222251211
1122114411111111122111111111111111111211
1122311112211111111111222222222222223211
11#2222222222222222222222222222222222#11
1111111111111111111111111111111111111111
0000000000000000000000000000000000000000
0000000000000000000000000000000000000000
0000000000000000000000000000000000000000

