X1111111111111111111111111111111111111111
1122222225222222222222222222222222222211
1122322522221111112222422242224222232211
1122222222212222222222223222222252222211
1122242222122222522223222222422222242211
1122223221222242222222232222222222232211
11222522221222222222#2222232252242222211
1112223222211111122222222222222222252211
11@222222222222221222224224222#222222211
1112222522225222221222222222222252222211
1122222222222222212222242242232222223211
1122525222222222122222222224222222522211
1122222222111111222222323#25224222222211
1122242222222222222242222222252242222211
1122222224222222522422222225223225222211
11222222222222#2222222222222222222252211
1122222422222222252222211111112225232211
1122225222223222222522111111111222222211
1122222222222224222221111111111122242211
1112242225222222222211111111111112222211
11@2222242225222422211111111111112242211
1112232222222222222211111111111112222211
1123242222522252222221111111111122232211
1125222522222222222222111111111222242211
1122322225232223222522211111112222232211
1122222222222242222222222222222222222211
1111111111111111111111111111111111111111
0000000000000000000000000000000000000000
0000000000000000000000000000000000000000
0000000000000000000000000000000000000000